+--+--+--+--+--+
   |        |  |
+  +  +--+  +  +
|  |     |     |
+  +--+  +--+--+
|     |        |
+--+  +--+--+  +
|     |     |  |
+  +--+  +  +  +
|        |      
+--+--+--+--+--+