+--+--+--+--+--+--+--+--+--+--+
      |              |        |
+  +  +  +--+--+  +--+  +--+  +
|  |  |        |        |     |
+  +--+--+--+  +--+  +--+  +--+
|           |     |  |     |  |
+--+--+  +--+--+  +--+  +--+  +
|        |        |     |     |
+  +  +--+  +  +--+  +--+  +  +
|  |        |  |           |  |
+  +--+--+--+  +  +--+--+--+  +
|        |     |  |     |     |
+--+--+  +  +--+  +--+  +  +--+
|        |     |        |  |  |
+  +--+--+--+  +  +--+--+  +  +
|     |        |  |     |     |
+--+  +--+--+--+  +  +  +--+--+
|  |     |        |  |  |     |
+  +--+  +  +--+--+  +  +--+  +
|        |           |
+--+--+--+--+--+--+--+--+--+--+