+--+--+--+--+--+--+--+--+--+--+--+--+--+--+--+--+--+--+--+--+--+--+--+--+--+--+--+--+--+--+
      |           |                 |  |                                |        |        |
+  +  +  +--+--+  +  +--+--+--+--+  +  +  +--+--+--+--+--+--+--+--+--+  +  +--+  +--+  +  +
|  |     |        |           |     |  |     |        |  |     |     |  |     |     |  |  |
+  +--+--+  +--+--+--+--+--+--+  +--+  +--+  +  +  +  +  +  +  +  +  +  +  +  +--+  +--+  +
|  |     |           |           |     |  |     |  |     |  |  |  |     |  |     |        |
+  +  +  +--+--+--+  +  +--+--+--+  +--+  +--+--+  +--+--+  +  +  +  +--+--+--+  +--+--+--+
|     |  |     |        |        |  |     |        |  |     |     |           |  |        |
+--+--+  +--+  +--+  +--+  +  +  +  +--+  +  +--+--+  +  +  +--+--+--+--+--+  +  +  +--+  +
|     |     |     |        |  |     |     |     |     |  |  |                    |  |  |  |
+  +  +--+  +--+  +--+--+--+  +--+--+  +  +--+  +  +  +--+  +--+--+--+--+  +--+--+  +  +  +
|  |              |        |  |        |     |  |  |           |  |     |           |     |
+  +--+--+--+--+--+--+--+  +  +  +--+--+  +  +  +  +--+--+--+  +  +  +  +--+  +--+--+--+--+
|  |        |           |     |  |        |  |  |     |        |     |     |     |        |
+  +  +--+  +  +--+--+  +--+--+  +--+--+--+  +  +--+  +--+--+--+--+--+--+  +--+  +  +--+  +
|     |     |        |        |  |     |     |     |     |        |     |        |  |  |  |
+--+--+  +--+--+--+--+--+--+  +  +  +  +  +--+--+--+--+  +  +--+  +  +  +--+--+--+  +  +  +
|           |           |     |  |  |  |  |           |  |     |  |  |           |  |     |
+  +--+  +--+  +--+--+  +  +  +  +--+  +  +--+--+--+  +  +--+  +  +--+--+  +--+--+  +--+--+
|  |           |        |  |  |        |  |     |     |        |     |     |        |     |
+  +--+--+--+--+  +--+--+--+  +--+--+--+  +  +  +  +--+  +--+--+--+  +  +  +  +--+--+--+  +
|  |        |        |     |        |     |  |     |     |     |     |  |  |     |     |  |
+  +  +--+  +--+--+  +--+  +--+--+  +  +--+  +--+--+  +--+--+  +  +  +  +--+--+  +  +  +  +
|  |  |  |           |        |     |  |     |        |  |     |  |  |     |     |  |  |  |
+  +  +  +--+--+--+--+  +  +--+  +--+  +--+  +  +--+--+  +  +--+  +  +--+  +--+  +  +  +  +
|  |     |     |        |           |     |  |  |     |  |        |  |     |     |  |     |
+  +--+--+--+  +--+  +--+--+  +  +  +--+  +  +  +--+  +  +--+--+--+  +--+  +  +  +  +--+  +
|  |              |        |  |  |     |  |  |     |     |        |        |  |  |  |  |  |
+  +  +--+--+--+  +--+--+  +  +  +--+  +  +  +  +  +  +--+  +  +--+--+--+--+  +--+  +  +  +
|  |  |           |     |  |  |  |  |     |  |  |     |     |        |           |  |     |
+  +  +  +--+--+--+--+  +  +--+  +  +--+--+  +  +--+--+--+--+  +--+  +  +--+  +  +  +--+  +
|  |  |           |     |  |     |  |     |  |        |        |     |     |  |  |     |  |
+  +  +--+--+--+  +  +--+  +  +--+  +  +  +  +--+--+  +  +  +--+  +--+--+  +  +  +--+  +  +
|  |  |        |  |        |        |  |  |           |  |  |     |        |  |        |  |
+  +  +  +--+  +  +  +--+--+--+--+--+--+  +--+--+  +--+  +  +  +  +  +--+--+  +--+--+--+--+
|     |  |  |        |        |     |                    |  |  |  |  |     |        |     |
+--+--+  +  +--+  +--+  +--+  +--+  +  +--+--+--+--+--+--+  +  +--+  +  +--+--+--+  +  +  +
|        |  |  |     |     |  |     |     |           |     |        |     |        |  |  |
+  +--+--+  +  +  +  +--+  +  +  +  +--+  +  +--+--+  +  +--+--+--+--+--+  +  +--+  +  +  +
|           |     |        |     |        |        |     |                    |        |   
+--+--+--+--+--+--+--+--+--+--+--+--+--+--+--+--+--+--+--+--+--+--+--+--+--+--+--+--+--+--+